##########################
#S.....#.................#
#.###..#.#############...#
#.#....#.#...........#...#
#.#.####.#.#########.#...#
#.#......#.#.......#.#...#
#.########.#.#####.#.#...#
#..........#.....#.#.#...#
################.#.#.####
#................#.#.....#
#.################.#####.#
#.#................#.....#
#.#.################.###.#
#.#..................#...#
#.##################.#.###
#....................#...#
#####.###################
#.....#..................#
#.###.#.################.#
#...#.#..................#
###.#.##################.#
#...#....................#
#.#######################
#.......................G#
##########################