S . . . # . . . . . . .
. # # . # . # # # . . .
. . . . . . . . # . . .
# # # . # # # . # . # .
. . . . . . . . . . . .
. # # # # . # # # # . .
. . . . . . . . . . . .
. # # # # # # . # # # .
. . . . . . . . . . . .
. # # . # # # . # # # .
. . . . . . . . . . . G
# # # # # . # # # . # .