####################
#S................#.
#.####.###########.#
#.#..#.#.........#.#
#.##.#.#.#######.#.#
#....#...#.....#.#.#
#.####.###.###.#.#.#
#.#....#...#.#.#.#.#
#.#.####.###.#.#.#.#
#.#.#....#...#.#.#.#
#.#.#.####.###.#.#.#
#.#.#.#....#...#.#.#
#.#.#.#.####.###.#.#
#.#.#.#.#......#.#.#
#.#.#.#.#.######.#.#
#.#...#.#........#.#
#.#####.##########.#
#.................#.
#.#################.
####################

####################
#..................#
#.################.#
#.#..............#.#
#.#.############.#.#
#.#.#..........#.#.#
#.#.#.########.#.#.#
#.#.#.#......#.#.#.#
#.#.#.#.####.#.#.#.#
#.#.#.#.#..#.#.#.#.#
#.#.#.#.#..#.#.#.#.#
#.#.#.#.####.#.#.#.#
#.#.#.#......#.#.#.#
#.#.#.########.#.#.#
#.#.#..........#.#.#
#.#.############.#.#
#.#..............#.#
#.################.#
#..................#
####################

####################
#..................#
#.#.##############.#
#.#.#............#.#
#.#.#.##########.#.#
#.#.#.#........#.#.#
#.#.#.#.######.#.#.#
#.#.#.#.#....#.#.#.#
#.#.#.#.#.##.#.#.#.#
#.#.#.#.#.##.#.#.#.#
#.#.#.#.#....#.#.#.#
#.#.#.#.######.#.#.#
#.#.#.#........#.#.#
#.#.#.##########.#.#
#.#.#............#.#
#.#.##############.#
#.#................#
#.#.##############.#
#..................#
####################

####################
#..................#
#.##############.#.#
#.#............#.#.#
#.#.##########.#.#.#
#.#.#........#.#.#.#
#.#.#.######.#.#.#.#
#.#.#.#....#.#.#.#.#
#.#.#.#.##.#.#.#.#.#
#.#.#.#.##.#.#.#.#.#
#.#.#.#....#.#.#.#.#
#.#.#.######.#.#.#.#
#.#.#........#.#.#.#
#.#.##########.#.#.#
#.#............#.#.#
#.##############.#.#
#................#.#
#.##############.#.#
#..................#
####################

####################
#..................#
#.################.#
#.#..............#.#
#.#.############.#.#
#.#.#..........#.#.#
#.#.#.########.#.#.#
#.#.#.#......#.#.#.#
#.#.#.#.####.#.#.#.#
#.#.#.#.#..#.#.#.#.#
#.#.#.#.#G.#.#.#.#.#
#.#.#.#.####.#.#.#.#
#.#.#.#......#.#.#.#
#.#.#.########.#.#.#
#.#.#..........#.#.#
#.#.############.#.#
#.#..............#.#
#.################.#
#..................#
####################