..........
.###......
.#........
.#..####..
....#.....
..........
.####.....
..........
.##.......
..........